111111111111111
1CEC0000C0E0PC1
111111111111111
