111111111111111
100C0000C0000C1
100000C00000001
100001111110001
1000000C11E0001
1000C0010C010C1
1000E001P000101
111111111111111
