11111111111
11100P11111
11E11C1C111
11111111111
