1111111111111111111
1000000000000000001
1001111111000000001
1011000001001111001
1010P00001111001001
10100C00C0000001001
10100000C0000001001
1011100000000E11001
1000111111111110001
1000000000000000001
1111111111111111111
