11111111111111
1000000000C001
1C0000000000C1
11111011111111
1P0000C0000E11
11111111111111
