111111111111111111111111111
1E0000000000000C00000C00101
101001010010000010100100101
101001001010101000100100101
1P0000000C00C00000000000101
111111111111111111111111111
