11111111111111
10000000000001
10000000000001
11111011111111
1P0000C0000E11
11111111111111
